1,X,X,X,O,X,O,X,X,X,X,X,X,X,X
X,X,X,P3,P1,P1,P1,P6,X,X,X,P3,P1,P1,D
X,X,O,P2,O,X,O,P2,O,X,O,P2,O,X,X
X,X,X,P2,X,X,X,P2,X,X,X,P2,X,X,X
X,X,O,P2,O,O,O,P2,O,O,O,P2,O,X,X
X,X,X,P2,X,X,X,P2,X,X,X,P2,X,X,X
X,X,O,P2,O,X,O,P2,O,X,O,P2,O,X,X
S,P1,P1,P4,X,X,X,P5,P1,P1,P1,P4,X,X,X
X,X,X,X,X,X,X,X,O,X,O,X,X,X,X
